300 300
----------
|EGEEGE|E|
|EEE|EE|E|
|E|E|EE|E|
|E|EEE-EE|
|E|E-EEEE|
|EE|EEEEE|
|EEE|EE-E|
|EEPEEEEE|
----------
