300 300
----------
|RGRRGRRR|
|RRR|RURR|
|E|E|ERRE|
|U|EEEEEE|
|E|E--EEE|
|EEEEEEEE|
|EEE|EEEE|
|EEP|RRRR|
----------
