630 630
E-------------------E
E|RRRRRRRR|RRRRRRRR|E
E|U--R---R|R---R--U|E
E|RRRRRRRRRRRRRRRRR|E
E|R--R|R-----R|R--R|E
E|RRRR|RRR|RRR|RRRR|E
E----R---E|E---R----E
EEEE|R|EEEEEEE|R|EEEE
-----R|E--Y--E|R-----
EEEEEREE|BIC|EEREEEEE
-----R|E-----E|R-----
EEEE|R|EEEEEEE|R|EEEE
E----R|E-----E|R----E
E|RRRRRRRR|RRRRRRRR|E
E|R--R---R|R---R--R|E
E|UR|RRRRRRRRRRR|RU|E
E--R|R|R-----R|R|R--E
E|RRRR|RRR|RRR|RRRR|E
E|R------R|R------R|E
E|RRRRRRRRRRRRRRRPR|E
E-------------------E