630 630
O-------------------O
O|RRRRRRRR|RRRRRRRR|O
O|U--R---R|R---R--U|O
O|RRRRRRRRRRRRRRRRR|O
O|R--R|R-----R|R--R|O
O|RRRR|RRR|RRR|RRRR|O
O----R---E|E---R----O
OOOO|R|UEEEEEU|R|OOOO
-----R|E--Y--E|R-----
EEEEEREE|BIC|EEREEEEE
-----R|U-----U|R-----
OOOO|R|EEEEEEE|R|OOOO
O----R|E-----E|R----O
O|RRRRRRRR|RRRRRRRR|O
O|R--R---R|R---R--R|O
O|UR|RRRRRRRRRRR|RU|O
O--R|R|R-----R|R|R--O
O|RRRR|RRR|RRR|RRRR|O
O|R------R|R------R|O
O|RRRRRRRRRRRRRRRPR|O
O-------------------O