400 400
----------------------------------------
FEEEE|EEEFFFF|EEEEEEEE|EEEFFFFF|EEEEEFF|
FE---|EE--FFF|EEE---EE|EEEFFFFF|EEEEEFF|
FEEEE|EEEFFFF|EEEEEEEE|EEEFFFFF|EEEEEFF|
EEEEEEEEEEEEEEEEEEEEEEEEEEEEEEEEEEEEEEE|
EEEEEEEEEE|-EEEEEEEEEEEEEE-|EEEEEEEEEEE|
EEEEEEEEEE|EEGEGEEEEGEEEGEE|EEEEEEEEEEE|
EEEEEEEEEE|----------------|EEEEEEEEEEE|
EEEEEEEEEEEEEEEEEEEPEEEEEEEEEEEEEEEEEEE|
---------------------------------------|
